XXXXXXXXXXXXXXXXXXXXXXXX
X                      X
X 1 2 3 4 5 6 7 8 9 0  X
X                      X
X  q w e r t y u i o p X
X                      X
X C a s d f g h j k l  X
X                      X
X    z x c v b n m   A X
X                      X
XXXXXXXXXXXXXXXXXXXXXXXX